7 5
#####
#.###
..#.#
#...#
#.#.#
#.#..
#####
