10 10
##########
#.......##
..#.######
#.##....##
#.##.##.##
#..#.##...
##.#.#####
##.#.##..#
#.......##
##########
